111111111111111111111111
1000000000000000E0000001
100000000000000000000001
10000C00000C000000000001
10000C000000000000000001
100000000C00000000000001
10P000000000000000000001
100000000C00000000000001
100000000C00000000000001
111111111111111111111111